16
16
113
1111111111111111
10000000000000011
0111111111111100
11001000010000111
0001011100111000
11101000110001101
0010101100111000
11010100111000111
0001010100011100
11101010111000111
0010101000111000
11000101101001111
0010010011010000
11111010010101111
0000101110001000
11001001011101111
0011110000010000
11100010011010111
0001101110011100
11100100011100111
0111011010001000
11000101011101111
0011100100010000
11000110101101111
0110100011000000
11001011001011111
0011011110111000
11000001000000111
0111101111111100
10000000000000011
0111111111111110
10000000000000001
1111111111111111