16
16
103
1111111111111111
10010000000101001
0100111110100010
10011010101011011
0010000001010100
11011101010011011
0000010010000010
11111000101111011
0000100101000100
11101011001111011
0111011001010010
11000100110101011
0010110111101100
11101100101010011
0001000110010110
11001011011101011
0001011000001000
11110101001010111
0010100110110100
11101111001001011
0001000010011100
11100011010010011
0011110101010110
11010010001110011
0000101111101100
11101001001100111
0111110010011000
10100001010000011
0001111101111110
11100000001000011
0011111111011100
11000000000000001
1111111111111111