16
16
55
1111111111111111
10000000000000011
0111110111011000
10000001001111111
0100100100100100
10111011110010001
0110100011000110
10110111011101111
0100100100011000
10011011101000101
0100101001111001
11111010011011001
0000010100100110
11101100101000101
0000101110010000
11111011011101011
0001101000001010
11010101011110101
0110011010001010
10001101100101011
0110000010010100
11001111001010101
0011100111101010
11000011000001001
0111000011100110
11000101100011011
0011111111010000
11000110000001111
0111000111111100
11000110000000011
0011101111111100
11000000000000001
1111111111111111