16
16
85
1111111111111111
11110000000000001
0000111111111110
11101000000000001
0000011111111110
10011100010000011
1000011100111100
10111100001000011
0100001101011100
10011100001000111
0110001010111000
10001110011000111
0111000111011100
11000100101000111
0011100100111000
11000011010000111
0011111000111111
11100011010000001
0001100110010100
11000110001000011
0111000111100100
10001110000010011
0110001111111100
10011110000000001
0100000111111110
10111110000000011
1000001111111100
10011100000000011
0000011111111111
11101000000000001
0000111111111110
11110000000000001
1111111111111111