16
16
33
1111111111111111
10000011000000011
0111101001000000
10000100101111101
0101010010001100
10001011101101011
0100101101101000
10110000100100101
0100110110110110
10100000010000101
0101010011011000
11001001001001011
0010101101110110
11010100100101001
0101000110101110
11001111010100011
0010000001011100
10000111001100101
0101000110011010
10000101000100001
0111110010110110
11100010001001001
0001011111011110
11111101000000001
0000100011100110
11010011000010111
0010110111011000
11001111110111011
0111000000000100
11000000001100101
0011100001111001
10000011110000001
1111111111111111