16
16
1111111111111111
10000000000000001
0110111111111110
10111000000011011
0000011001000010
11111100111110111
0100001100000100
10011110010101111
1000011011110000
10100100000000001
0101001110111111
10011100110001001
1010001000101010
10010110100100111
0101100010011101
10100111011000001
0001010000111010
11111011011001101
0000000110000100
11101110101110011
0000110100011101
11110010010101101
0000101000101000
11001111101010111
0010010111010001
11110000010001011
0101101011101000
11000000100010101
0011010001010111
11101001010001001
0000100000101000
11010010101000111
1111111111111111